50 45
-100 150
01 01 01 01 01 01 01 01 01 01 01 01 01 01 01 01 01 01 01 01 01 01 01 01 01 01 01 01 01 01 01 01 01 01 01 01 01 01 01 01 01 01 01 01 01 01 01 01 01 01
01 00 00 00 00 00 01 00 00 00 00 00 00 00 00 00 00 00 00 00 48 01 01 01 01 01 00 00 00 00 00 00 00 48 01 00 00 00 00 00 00 00 00 00 00 00 00 00 00 01
01 00 00 00 00 00 01 00 55 55 55 00 00 00 00 00 00 00 00 00 00 01 01 01 01 01 00 00 00 00 00 00 00 00 01 00 00 00 00 00 00 00 00 00 00 00 00 00 00 01
01 00 00 00 01 01 01 00 00 00 00 00 00 00 00 00 00 00 00 00 00 01 00 00 00 02 00 00 00 00 00 00 00 00 01 00 00 00 00 00 00 00 00 00 00 00 00 00 00 01
01 00 00 00 01 00 00 00 00 00 00 00 01 00 00 00 01 01 01 01 01 01 00 00 00 02 00 00 05 00 00 00 00 00 01 00 00 00 00 00 00 44 00 00 00 00 00 00 00 01
01 00 00 00 01 00 00 00 37 00 00 00 01 00 00 00 00 00 00 00 00 00 00 00 01 01 00 00 00 00 00 00 00 00 01 00 00 00 00 00 00 00 36 00 00 00 00 36 00 01
01 00 00 00 01 00 00 00 00 00 00 00 01 00 55 55 55 55 00 00 00 00 00 00 01 01 00 00 00 00 00 00 00 00 01 00 00 00 00 00 00 00 00 00 00 00 00 00 00 01
01 00 00 00 01 00 00 00 00 00 00 00 01 00 00 00 00 00 00 00 35 00 00 00 01 01 00 00 00 00 00 00 00 00 01 00 00 00 00 00 00 00 00 00 00 00 00 00 00 01
01 00 00 00 01 00 00 00 35 00 00 00 01 01 01 01 01 01 01 01 01 01 01 01 01 01 00 00 00 00 00 00 00 00 01 00 00 00 00 36 01 01 00 00 00 00 00 00 00 01
01 00 00 00 01 00 00 00 01 01 01 01 01 00 00 00 00 00 00 00 00 00 01 01 01 01 00 00 00 00 00 00 00 00 01 00 00 00 00 00 01 01 00 00 00 00 00 00 00 01
01 00 00 00 01 00 00 00 00 00 00 00 00 00 00 00 00 00 00 00 00 00 01 01 01 01 00 00 00 00 00 00 00 00 01 00 00 00 00 00 01 01 00 00 00 35 00 00 00 01
01 00 00 00 01 00 00 00 00 00 00 00 00 00 00 00 00 00 00 00 00 00 01 01 01 01 00 00 00 00 00 00 00 00 01 00 00 00 00 00 01 01 00 00 00 00 00 00 00 01
01 00 00 00 01 00 00 00 00 00 00 00 00 00 35 00 00 00 00 00 00 00 01 01 01 01 00 00 00 37 00 00 00 36 01 00 00 00 00 00 01 01 00 00 00 00 00 00 00 01 
01 00 00 00 01 01 01 01 01 01 01 01 01 01 01 01 01 01 01 00 00 00 01 01 01 01 00 00 00 00 00 00 00 00 01 37 00 00 00 00 01 01 00 00 00 00 00 00 00 01 
01 00 00 00 01 00 00 00 00 00 00 00 00 00 00 00 01 01 01 00 00 00 01 01 01 01 00 00 00 00 00 00 00 00 01 00 00 00 00 00 01 01 00 00 00 00 00 00 00 01 
01 00 00 00 01 00 00 00 00 00 00 00 00 00 00 00 00 03 01 34 00 00 01 01 01 01 00 00 00 00 44 00 00 00 00 00 00 00 00 00 01 01 00 00 00 00 00 00 00 01 
01 00 00 00 01 00 00 00 00 00 00 00 00 00 00 00 00 00 01 00 00 00 01 01 01 01 00 00 00 00 00 00 00 00 00 00 00 00 00 00 01 01 00 00 00 00 00 00 00 01 
01 00 00 00 01 00 00 01 01 01 01 01 01 01 01 01 01 01 01 00 00 36 01 01 01 01 00 00 00 00 00 00 00 00 00 00 00 00 00 00 01 01 00 00 00 00 00 00 00 01 
01 00 00 00 01 00 00 01 00 00 00 00 00 00 00 00 00 01 01 00 00 00 01 01 01 01 00 00 00 00 00 00 00 35 00 00 00 00 00 00 01 01 00 00 00 35 00 00 00 01 
01 00 00 00 01 00 00 01 01 01 01 01 01 01 01 01 01 01 01 00 00 00 01 01 01 01 00 00 00 00 00 00 00 00 01 00 00 00 00 00 01 01 00 00 00 00 00 00 00 01 
01 00 00 00 01 00 00 00 00 00 00 00 00 00 00 00 00 01 01 00 00 00 01 01 01 01 00 00 00 00 37 00 00 00 01 00 00 00 00 00 01 01 00 00 00 00 00 00 00 01 
01 00 00 00 01 00 00 00 00 00 00 00 00 00 00 00 00 00 00 00 00 00 01 01 01 01 00 00 00 00 00 00 00 00 01 00 00 00 00 00 01 01 00 00 00 00 00 00 00 01 
01 00 00 00 01 00 00 00 00 00 00 00 00 00 00 00 00 35 00 00 00 00 01 01 01 01 00 00 00 00 00 00 00 00 01 00 00 00 00 00 01 01 00 00 00 00 00 00 00 01 
01 00 00 00 01 01 01 01 01 01 01 01 01 01 01 01 01 01 01 01 01 01 01 01 01 01 01 01 01 01 01 01 01 01 01 01 01 01 01 01 01 01 01 01 01 01 00 00 00 01
01 00 00 00 00 00 00 00 00 00 00 00 00 00 00 00 00 00 00 00 00 00 00 00 00 00 00 00 00 00 00 00 00 00 00 00 00 00 00 00 00 00 00 00 01 01 00 00 00 01
01 00 00 00 00 00 00 00 00 00 00 00 00 00 00 00 00 00 00 00 00 00 00 00 00 00 00 00 00 00 00 00 00 00 00 00 00 00 00 00 00 00 00 00 01 01 00 00 00 01
01 00 00 00 00 00 00 00 00 00 00 00 00 00 00 00 00 00 00 00 00 00 00 00 00 00 00 00 00 00 00 00 00 00 00 00 00 00 00 00 00 00 00 00 01 01 00 00 00 01
01 00 00 00 00 00 00 00 00 00 00 00 00 00 00 00 00 00 00 00 00 00 00 00 00 00 00 00 00 00 00 00 00 00 00 00 00 00 00 00 00 00 00 00 01 01 00 00 00 01
01 01 01 01 01 01 01 01 01 01 01 01 01 01 01 01 01 01 01 01 01 01 01 01 01 01 01 01 01 01 01 01 01 01 01 01 01 01 00 00 00 01 01 01 01 01 00 00 00 01
01 00 00 00 00 00 00 00 00 00 00 00 00 00 00 00 00 00 00 00 00 00 00 00 00 00 00 00 00 00 00 00 00 00 00 00 01 01 00 00 00 01 01 01 01 01 00 00 00 01
01 00 00 00 00 00 00 00 00 00 00 00 00 00 00 00 00 00 00 00 00 00 00 00 00 00 00 00 00 00 00 00 00 00 00 00 01 01 00 00 00 01 01 01 01 01 00 00 00 01
01 00 00 00 00 00 00 00 00 00 00 00 00 00 00 00 00 00 00 00 00 00 00 00 00 00 00 00 00 00 00 00 00 00 00 00 00 00 00 00 00 00 00 00 01 01 00 00 00 01
01 00 00 00 00 00 00 00 00 00 00 00 00 00 00 00 00 00 00 00 00 00 00 00 00 00 00 00 00 00 00 00 00 00 00 00 00 00 00 00 00 00 00 00 01 01 00 00 00 01
01 00 00 00 00 00 00 00 00 00 00 00 00 00 00 00 00 00 00 00 00 48 00 00 00 00 00 00 00 00 00 00 00 00 00 00 00 00 00 00 00 00 00 00 01 01 00 00 00 01
01 00 00 00 00 00 00 00 48 00 00 00 00 00 00 00 00 00 00 00 00 00 00 00 00 00 00 00 00 00 00 00 00 00 00 00 00 00 00 00 00 00 00 00 01 01 00 00 00 01
01 00 00 00 00 00 00 00 00 00 00 00 00 00 00 00 00 00 00 00 00 00 00 00 00 00 00 00 00 00 00 00 00 00 00 00 00 00 00 00 00 00 00 00 01 01 00 00 00 01
01 00 00 00 00 00 00 00 00 00 00 00 00 00 00 00 00 00 00 00 00 00 00 00 00 00 00 00 00 00 00 00 00 00 00 00 00 48 00 00 00 00 00 00 01 01 00 00 00 01
01 00 00 00 00 00 00 00 00 00 00 00 00 00 00 00 00 48 00 00 00 00 00 00 00 00 00 00 00 00 00 00 00 00 00 00 00 00 00 00 00 00 00 00 01 01 00 00 00 01
01 00 00 00 00 00 00 00 00 00 00 00 00 00 00 00 00 00 00 00 00 00 00 00 00 00 00 00 00 00 00 00 00 00 00 00 00 00 00 00 00 00 00 00 00 00 00 00 00 01
01 00 00 00 00 00 00 00 00 00 00 00 00 00 00 00 00 00 00 00 00 00 00 00 00 00 00 00 00 00 00 00 00 00 00 00 00 00 00 00 00 00 00 00 00 00 00 00 00 01
01 00 00 00 00 00 00 00 00 00 00 48 00 00 00 00 00 00 00 00 00 00 00 00 00 00 00 00 00 00 00 00 00 00 00 00 00 00 00 00 00 00 00 00 00 00 00 00 00 01
01 00 00 00 00 00 00 00 00 00 00 00 00 00 00 00 00 00 00 00 00 00 00 00 00 00 00 00 00 00 00 00 00 00 00 00 00 00 00 00 00 00 00 00 00 00 00 00 00 01
01 00 00 00 00 00 00 00 00 00 00 00 00 00 00 00 00 00 00 00 00 00 00 00 00 00 00 00 00 00 00 00 00 00 00 00 00 00 00 00 00 00 00 00 01 01 00 00 00 01
01 00 00 00 00 00 00 00 00 00 00 00 00 00 00 00 00 00 00 00 00 00 00 00 00 00 00 00 00 00 00 00 00 00 00 00 00 00 00 00 00 00 00 00 01 01 00 00 00 01
01 01 01 01 01 01 01 01 01 01 01 01 01 01 01 01 01 01 01 01 01 01 01 01 01 01 01 01 01 01 01 01 01 01 01 01 01 01 01 01 01 01 01 01 01 01 01 01 01 01
