28 40
0 -800
01 01 02 01 01 01 01 01 01 01 01 01 01 01 01 01 01 01 01 01 01 01 01 01 01 01 01 01
01 01 00 00 00 01 01 01 01 01 01 01 01 01 01 01 01 01 01 01 01 01 01 01 01 01 01 01
01 01 00 00 00 00 00 00 00 00 00 00 00 00 00 00 00 00 00 00 00 00 00 00 00 00 01 01
01 01 00 00 55 55 55 00 00 66 00 00 00 00 55 00 55 00 00 99 00 00 00 00 00 00 01 01
01 01 00 00 00 00 00 00 00 00 00 00 00 00 55 00 55 00 00 00 00 00 00 00 00 00 01 01
01 01 00 00 00 00 00 00 00 00 00 00 00 00 55 00 55 00 00 00 00 00 00 00 00 00 01 01
01 01 01 01 01 01 01 01 01 01 01 01 00 00 00 00 00 48 00 00 00 00 00 00 00 00 01 01
01 01 01 01 01 01 01 01 01 01 01 01 00 00 00 00 00 00 00 00 00 00 00 55 00 00 01 01
01 01 01 01 01 01 01 01 01 01 01 00 00 00 00 00 00 00 00 00 00 00 55 55 55 00 01 01
01 01 01 01 01 01 01 01 01 01 00 00 00 00 00 00 00 00 00 00 00 00 00 55 00 00 01 01
01 01 88 00 00 00 00 01 00 00 00 00 00 00 00 00 00 00 00 00 00 00 00 00 00 00 01 01
01 01 00 00 00 00 00 00 01 88 00 01 01 01 00 00 00 00 00 01 01 01 00 00 00 00 01 01
01 01 00 00 00 00 00 00 00 01 00 01 01 01 01 00 00 00 01 01 01 01 00 00 00 00 01 01
01 01 00 55 55 55 00 00 00 00 01 01 01 55 55 01 00 01 55 55 01 01 55 00 55 00 01 01
01 01 00 00 00 55 55 55 55 00 00 01 01 55 55 00 01 00 55 55 01 01 00 55 00 00 01 01
01 01 00 00 00 00 00 00 00 00 00 01 01 00 00 00 01 00 00 00 01 01 55 00 55 00 01 01
01 01 00 00 00 00 00 00 00 00 00 00 01 00 00 00 01 00 00 00 01 00 00 00 00 00 01 01
01 01 00 00 00 44 00 00 00 00 00 00 00 00 00 88 01 88 00 00 00 00 00 00 00 00 01 01
01 01 00 00 00 00 00 00 00 00 00 00 99 00 01 01 01 01 01 00 00 00 00 66 00 00 01 01
01 01 00 00 00 00 00 00 00 00 00 00 00 00 00 88 01 88 00 00 00 00 00 00 00 00 01 01
01 01 00 00 00 35 00 00 00 00 00 00 01 00 00 00 01 00 00 00 01 00 00 00 00 00 01 01
01 01 00 00 00 01 01 00 00 00 00 01 01 00 00 00 01 00 00 00 01 01 00 00 00 00 01 01
01 01 00 00 00 01 01 00 00 00 00 01 01 55 55 00 00 00 55 55 01 01 00 00 00 00 01 01
01 01 00 00 00 01 01 00 00 00 00 01 01 55 55 00 00 00 55 55 01 01 00 00 00 00 01 01
01 01 00 00 00 01 01 00 00 00 00 01 01 01 01 00 00 00 01 01 01 01 00 00 00 00 01 01
01 01 00 00 00 01 01 00 00 00 00 01 01 01 00 99 00 00 00 01 01 01 00 00 00 00 01 01
01 01 00 00 00 01 01 00 00 00 00 00 01 00 00 00 00 00 00 00 00 00 00 00 00 00 01 01
01 01 00 00 00 01 01 00 00 00 00 00 00 01 00 00 00 00 00 00 00 00 00 00 00 00 01 01
01 01 00 00 00 37 00 00 00 00 00 00 00 00 01 00 00 00 00 00 00 00 00 00 00 00 01 01
01 01 00 00 00 00 00 00 00 00 00 00 00 00 00 01 00 00 00 00 00 00 00 55 00 00 01 01
01 01 00 00 00 00 00 00 00 00 48 00 00 00 00 00 01 00 00 00 00 00 55 55 55 00 01 01
01 01 01 01 01 01 01 00 00 00 00 00 00 00 00 00 00 01 00 00 00 55 00 55 00 55 01 01
01 01 01 01 01 01 01 00 00 00 00 00 00 00 00 00 00 00 01 00 00 55 00 55 00 55 01 01
01 01 01 01 01 01 01 00 00 00 00 00 00 00 00 00 00 00 00 01 00 55 00 55 00 55 01 01
01 01 00 00 55 00 00 34 00 00 00 00 00 00 00 00 00 00 00 00 01 55 00 55 00 55 01 01
01 01 00 55 88 55 00 00 00 00 00 00 00 00 00 00 00 00 00 00 00 01 55 55 55 00 01 01
01 01 00 55 88 55 00 00 00 00 00 00 00 00 00 00 00 00 00 00 00 00 01 55 00 00 01 01
01 01 00 00 55 00 00 00 00 00 00 00 00 00 00 00 00 00 00 00 00 00 00 01 01 01 01 01
01 01 01 01 01 01 01 01 01 01 01 01 01 01 01 01 01 01 01 01 01 01 01 01 01 01 01 01
01 01 01 01 01 01 01 01 01 01 01 01 01 01 01 01 01 01 01 01 01 01 01 01 01 01 01 01




